####################
#      X    X      #
#                  #
#     X      X     #
#   #  #XXXX#  #   #
#   XX##    ##XX   #
#                  #
#    ##      ##    #
#                  #
#   XX##    ##XX   #
#   #  #XXXX#  #   #
#     X      X     #
#                  #
#      X    X      #
####################
