####################
#      X     X     #
#   XXXX    XXXXX  #
#   #  #  X  #  #  #
#   XXXX    XXXX   #
#        X   X  X  #
#   X   X          #
#       XXXX   X   #
#   X   #    #     #
#       XXXX   X   #
#   X              #
#         X        #
#   #  #    #  #   #
#  X         X     #
####################
