####################
#       X X        #
#   ###X    ###X   #
#   X  X    X  X   #
#   X###  X ###X   #
#   X   X    X X   #
#   X    XX    X   #
#       xxxx   X   #
#   X  X    X  X   #
#   X   XXXX   X   #
#   X       X   X  #
#   X     X     X  #
#    X  X  X    X  #
#      XX    X     #
####################
