####################
#    XXXXXXXXXX    #
#   XXXXXXXXXXXX   #
#   X  X    X  X   #
#   X###    ###X   #
#   X   X    X     #
#   X    #X    X   #
#     X   XXX  X   #
#   X   X   X      #
#       X       X  #
#     X  X  X   X  #
#   X       X   #  #
#   XXXXXXXXXXXX   #
#     XXXXXXXX     #
####################
