####################
#    XXXXXXXXXX    #
#   XXXXXXXXXXXX   #
#   X  X    X  X   #
#   X###    ###X   #
#   X          #   #
#   X    ##    X   #
#   #   ####   X   #
#   X    ##    #   #
#   X          X   #
#   #          X   #
#   X          #   #
#   XXXXXXXXXXXX   #
#     XXXXXXXX     #
####################
